$(	PUN
$,	PUN
$.	PUN
$:	PUN
$'	PUN
$''	PUN
$``	PUN
\$(	PUN
\$,	PUN
\$.	PUN
A	ADJ
ABNN	NN
ADJ	ADJ
ADJA	ADJ
ADJD	ADJ
ADV	ADV
ADV	ADV
ADVK	ADV
ADVL	ADV
ADVM	ADV
ADVT	ADV
ANTHRO	NE
AP	AP
AP+ART	AP+ART
APPO	AP
APPO	AP
APPR	AP
APPRART	AP
APPRK	AP
APPRL	AP
APPRM	AP
APPRT	AP
APZR	AP
ART	ART
ARTB	ART
ARTU	ART
AUX	AUX
AUXG	V
B	XY
Berufsbezeichnung	NN
CARD	NUM
CC	CON
CD	NUM
companyName	NE
CON	CON
CONCOO	CON
CONSUB	CON
DIST	XY
DT	ART
EIG	NE
ENGLISH	ENGLISH
ET	ET
event	NN
EX	EX
FM	XY
FW	XY
Gebirge	NE
geoCity	NE
geoCountry	NE
geoLocation	NE
Gew√§ssername	NE
I	ITJ
IN	AP
ITJ	ITJ
Jahreszeit	NN
JJ	ADJ
JJR	ADJ
JJS	ADJ
KO	CON
KOKOM	CON
KON	CON
KOUI	CON
KOUS	CON
KOUU	CON
KOVGL	CON
LATEIN	LATIN
-LRB-	XY
LS	XY
MD	V
Monatsname	NE
n	NN
N	NN
NE	NE
NEP	NE
NN	NN
NNE	NE
NNP	XY
NNPS	NN
NNS	NN
NP	NE
NU	NUM
NUK	NUM
NULL	XY
NUM	NUM
number	NUM
OIKO	NE
P	PRO
PART	PTC
PARZPF	V
PARZPFPR	V
PARZPR	V
PARZPRPR	V
PAV	ADV
PD	PRODEM
PDAT	PRODEM
PDS	PRODEM
PDT	PRO
PERP	PROPER
personName	NE
PI	PROIND
PIAT	PROIND
PIDAT	PROIND
PIS	PROIND
POS	PUN
PPER	PROPER
PPOS	PROPOS
PPOSAT	PROPOS
PPOSS	PROPOS
PREL	PROREL
PRELAT	PROREL
PRELS	PROREL
PRF	PROPER
PRO	PRO
PROAV	ADV
PRODEM	PRODEM
professionName	NN
PROIND	PROIND
PROINT	PROINT
PROPER	PROPER
PROPOS	PROPOS
PROREF	PROREF
PROREL	PROREL
PROREZ	PROREZ
PRP$	XY
PRP$-DEI	XY
PRP$-PLE	XY
PRP	PRO
PRP-DEI	XY
PTC	PTC
PTKA	PTC
PTKANT	PTC
PTKNEG	PTC
PTKVZ	PTC
PTKZU	PTC
PUN	PUN
PWAT	PROINT
PWAV	PROINT
PWS	PROINT
RB	ADV
RBR	ADV
RBS	XY
RP	ADV
-RRB-	XY
s	XY
SPACE	SPACE
Stundenname	NN
SUB	XY
SYM	XY
SZ	PUN
SZE	PUN
SZN	PUN
SZT	PUN
Tageszeit	NN
titleName	NN
TO	TO
TRUNC	TRUNC
UH	ITJ
UNB	XY
UNKNOWN	XY
URL	URL
V	V
VAFIN	AUX
VAIMP	AUX
VAINF	AUX
VAPP	AUX
VB	AUX
VBD	V
VBG	V
VBN	V
VBP	V
VBZ	V
VMFIN	V
VMINF	V
VMPP	V
VPI	VPI
VPII	VVPP
VV	V
VVEIMZ	V
VVFIN	V
VVIMP	V
VVINF	V
VVIZU	V
VVPP	V
WDT	ART
Wochenname	NN
WP$	PRO
WP	PROINT
WRB	CON
XY	XY
ZUS	XY